10
10
>$$$$$$$$$
$##$##$##$
$##$##$##$
$$$$$$$$$$
$##$##$##$
$##$##$##$
$$$$$$$$$$
$##$##$##$
$##$##$##$
$$$$$$$$$$
